111111111111111111
1E001000000010C001
101100011101000011
1001101C0000001011
10C000011110000P01
111111111111111111