11111111111111111111111111111111111111111111111111111111111
10000000000000000000000000000000000000000010000000000000001
100000P00000000000000000C0000000001000000010000000000000001
100000000000000000000000000000000010000000100000000C0000001
10000000000001111000000000000000000000000010000000000000001
10000000000000000000000010000000000000000000000000000000001
1000000111000000000000001000000C000000000000000000000000001
10000000000000000000000010000000000000000001111000000000001
10000000000011111100000010000000000000000000000000000000001
10000010000000000000000000000000000001000000000000000000001
100000100000C0000010000000000000000001000000000000000000001
10000010000000000010000000000000000001000000000000000000001
10000010000000000010000000000000000001000000000000000000001
1000001000000000001000000000C0000000000000000000000000E0001
10000010000000000010000000000000000000000000000000000000001
11111111111111111111111111111111111111111111111111111111111