111111111111111111
100110A0000000C001
1000P0001110000011
1001100C0001100001
10C000011000001E01
111111111111111111